groupid,stimu,stimu_time,resp,resp_time,rt
1,7,31064,201,31819,755
2,5,33439,202,34076,637
3,3,35997,202,36508,511
4,3,38389,201,38972,583
5,7,40814,201,41421,607
6,7,43222,201,43725,503
7,5,45547,201,46382,835
8,5,48022,202,48574,552
9,3,50456,201,51022,566
10,7,53023,201,53631,608
11,3,55573,202,56143,570
12,5,57981,201,58495,514
13,7,60556,201,61200,644
14,5,62823,201,63376,553
15,7,65165,201,65792,627
16,3,67431,201,68033,602
17,5,69798,201,70353,555
18,3,72240,202,72689,449
19,7,74840,201,75330,490
20,3,77282,201,77746,464
21,5,79682,202,80259,577
22,3,82015,201,82531,516
23,5,84415,201,84931,516
24,7,86807,201,87412,605
25,3,89099,201,89668,569
26,7,91482,201,91988,506
27,5,94065,201,94645,580
28,3,96632,202,97125,493
29,3,99157,201,99717,560
30,5,101657,201,102278,621
31,5,104107,201,104662,555
32,7,106616,201,107351,735
33,7,108832,201,109495,663
34,3,111316,202,112103,787
35,7,113716,201,114264,548
36,5,115941,201,116568,627
37,5,118233,201,118744,511
38,3,120499,201,121065,566
39,7,122766,201,123369,603
40,5,125050,202,125673,623
41,5,127266,201,127818,552
42,7,129708,201,130234,526
43,3,132016,202,132426,410
44,7,134233,201,134843,610
45,3,136750,202,137243,493
46,7,209377,201,209958,581
47,7,211644,201,212150,506
48,5,214202,201,214870,668
49,5,216627,202,217223,596
50,5,219060,201,219607,547
51,5,221360,202,221960,600
52,5,223786,202,224472,686
53,3,226377,202,226936,559
54,3,228827,202,229337,510
55,5,231327,201,231913,586
56,3,233919,201,234601,682
57,7,236161,201,236810,649
58,7,238511,201,239098,587
59,5,240794,201,241354,560
60,7,243353,201,243963,610
61,3,245561,202,246059,498
62,7,247861,201,248603,742
63,7,250411,201,250988,577
64,3,252895,202,253420,525
65,5,255345,201,256093,748
66,7,257611,201,258157,546
67,3,259912,201,260509,597
68,7,262237,201,262894,657
69,3,264828,202,265390,562
70,5,267412,201,267966,554
71,3,269862,202,270543,681
72,7,272204,201,272783,579
73,3,274770,201,275503,733
74,7,277329,201,277856,527
75,3,279804,202,280560,756
76,7,282037,201,282688,651
77,5,284329,201,284929,600
78,5,286862,201,287441,579
79,5,289254,201,290018,764
80,3,291629,201,292290,661
81,5,294062,201,294802,740
82,5,296579,202,297219,640
83,5,298938,201,299539,601
84,3,301429,201,302115,686
85,7,303788,201,304324,536
86,3,306054,201,306740,686
87,7,308630,201,309444,814
88,7,310930,202,311877,947
89,3,313180,201,313989,809
90,3,315488,202,316325,837
91,3,414141,201,414900,759
92,7,731558,201,732243,685
93,7,733866,201,734355,489
94,5,736358,202,737092,734
95,7,738858,201,739476,618
96,3,741433,202,742020,587
97,7,743733,201,744325,592
98,5,746167,202,746997,830
99,7,748717,201,749381,664
100,3,751167,202,751862,695
101,3,753708,201,754262,554
102,5,756217,201,756694,477
103,5,766067,201,766568,501
104,5,777934,201,778490,556
105,7,780384,201,780666,282
106,3,782843,202,783418,575
107,5,787509,201,787979,470
108,5,790059,201,790635,576
109,3,792593,202,793180,587
110,3,1030583,202,1031295,712
111,3,1032908,202,1033551,643
112,7,1035416,201,1036000,584
113,7,1037633,201,1038176,543
114,3,1040183,202,1040752,569
115,7,1042666,201,1043233,567
116,7,1045116,201,1045841,725
117,7,1047566,201,1048209,643
118,3,1050133,202,1050738,605
119,5,1052633,202,1053186,553
120,5,1054842,201,1055458,616
121,5,1057092,201,1057715,623
122,7,1059525,201,1060163,638
123,7,1061884,202,1062548,664
124,3,1064359,202,1064964,605
125,5,1066942,201,1067652,710
126,5,1069525,201,1070261,736
127,7,1071842,202,1072757,915
128,7,1074342,201,1075061,719
129,3,1076767,202,1077366,599
130,7,1079142,201,1079750,608
131,5,1081442,201,1082150,708
132,7,1083851,201,1084775,924
133,3,1086068,202,1086807,739
134,5,1088409,201,1089143,734
135,5,1090993,201,1091592,599
136,7,1093484,201,1094104,620
137,5,1095868,201,1096585,717
138,5,1098410,201,1099113,703
139,5,1100968,201,1101625,657
140,3,1103393,202,1104074,681
141,3,1105693,201,1106314,621
142,3,1108160,201,1108794,634
143,7,1110435,201,1111067,632
144,3,1112827,201,1113531,704
145,3,1115277,201,1115979,702
146,7,1117852,202,1118716,864
147,7,1120385,201,1121132,747
148,5,1122735,201,1123565,830
149,5,1125152,202,1126205,1053
150,3,1127752,201,1128333,581
151,3,1130244,201,1130878,634
152,3,1132685,201,1133358,673
153,5,1135211,201,1135854,643
154,5,1137477,201,1138175,698
155,5,1209138,201,1209577,439
156,5,1211479,201,1212170,691
157,3,1214038,202,1214730,692
158,7,1216479,201,1217034,555
159,3,1218921,202,1219499,578
160,5,1221321,201,1221963,642
161,3,1223896,201,1224699,803
162,7,1226496,201,1227100,604
163,3,1228946,202,1229724,778
164,7,1231272,201,1231917,645
165,3,1233605,201,1234285,680
166,7,1235988,201,1236573,585
167,5,1238288,201,1238974,686
168,3,1240522,201,1241342,820
169,7,1252564,201,1253104,540
170,3,1254772,201,1255360,588
171,7,1256997,202,1257792,795
172,5,1263939,202,1264545,606
173,5,1266289,201,1266834,545
174,5,1268873,201,1269474,601
175,5,1271081,201,1271762,681
176,3,1273614,202,1274211,597
177,5,1275914,201,1276451,537
178,5,1278414,201,1278963,549
179,3,1280806,201,1281540,734
180,3,1290290,202,1290933,643
181,3,1292798,201,1293382,584
182,5,1295373,202,1296086,713
183,5,1297815,201,1298502,687
184,7,1300407,201,1301063,656
185,3,1302632,202,1303351,719
186,7,1304932,201,1305655,723
187,5,1307399,202,1308392,993
188,3,1541005,201,1541626,621
189,3,1543388,202,1544059,671
190,5,1545988,201,1546635,647
191,3,1548389,201,1548891,502
192,3,1550839,201,1551452,613
193,5,1553347,202,1554124,777
194,7,1555764,201,1556300,536
195,7,1558322,201,1558893,571
196,7,1560906,202,1561693,787
197,3,1563431,201,1563934,503
198,5,1565856,201,1566398,542
199,3,1568089,201,1568782,693
200,3,1570597,202,1571263,666
201,7,1573098,201,1573567,469
202,3,1575514,201,1576159,645
203,7,1577898,201,1578560,662
204,7,1580306,201,1580976,670
205,3,1582714,201,1583600,886
206,7,1585265,201,1585873,608
207,7,1587473,201,1588065,592
208,7,1589765,202,1590273,508
209,5,1592306,202,1593106,800
210,7,1594815,201,1595346,531
211,5,1597057,201,1597602,545
212,5,1599532,201,1600211,679
213,7,1601957,202,1602675,718
214,5,1604482,201,1605076,594
215,5,1606773,201,1607428,655
216,7,1609307,201,1610020,713
217,5,1611590,201,1612261,671
218,5,1613865,201,1614437,572
219,5,1616415,202,1616869,454
220,3,1618749,202,1619142,393
221,5,1620982,201,1621430,448
222,3,1623391,201,1623910,519
223,3,1625774,201,1626327,553
224,7,1627999,201,1628695,696
225,5,1630474,202,1631047,573
226,7,1632783,201,1633480,697
227,3,1634991,202,1635784,793
228,3,1637299,201,1637992,693
229,5,1803671,201,1804337,666
230,7,1806079,201,1806657,578
231,5,1808429,201,1809010,581
232,3,1810946,202,1811538,592
233,3,1864747,201,1865418,671
234,7,1867089,201,1867754,665
235,3,1869297,202,1869883,586
236,7,1871506,201,1872059,553
237,5,1873797,202,1874395,598
238,3,1876231,201,1876876,645
239,5,1878756,202,1879388,632
240,3,1881264,202,1881804,540
241,5,1883514,201,1884157,643
242,3,1885939,201,1886717,778
243,5,1888273,201,1888973,700
244,3,1890773,202,1891406,633
245,5,1893090,201,1893630,540
246,3,1895331,202,1896063,732
247,3,1897848,201,1898447,599
248,5,1900106,0,0,0
249,7,1910182,202,1910929,747
250,7,1912448,201,1913121,673
251,5,1914790,201,1915425,635
252,7,1917257,201,1917938,681
253,3,1919624,201,1920210,586
254,3,1922007,202,1922546,539
255,5,1924540,201,1925123,583
256,5,1926966,201,1927587,621
257,5,1929449,201,1930020,571
258,7,1931799,201,1932372,573
259,7,1934016,201,1934660,644
260,5,1936399,202,1937013,614
261,7,1938841,201,1939349,508
262,7,1941308,201,1941909,601
263,3,1943541,201,1944182,641
264,7,1945908,202,1946470,562
265,5,1950500,201,1951079,579
266,5,1952850,202,1953591,741
267,3,1955391,201,1956007,616
268,7,1957616,201,1958152,536
269,3,1960033,202,1960568,535
270,3,2138571,201,2139186,615
271,7,2140980,201,2141571,591
272,3,2143505,202,2144067,562
273,7,2146080,201,2146532,452
274,5,2148330,201,2148900,570
275,5,2150797,201,2151156,359
276,3,2153005,201,2153669,664
277,5,2155230,201,2155845,615
278,7,2157822,202,2158629,807
279,3,2160164,202,2160742,578
280,3,2162397,202,2162998,601
281,7,2164897,201,2165494,597
282,7,2167439,201,2167975,536
283,5,2170014,202,2170503,489
284,5,2172239,201,2172919,680
285,5,2174472,201,2175208,736
286,7,2176939,202,2177720,781
287,5,2179156,201,2179816,660
288,7,2181606,201,2182201,595
289,7,2184048,202,2184713,665
290,7,2186473,201,2186937,464
291,5,2188889,201,2189290,401
292,3,2191098,202,2191594,496
293,5,2193340,201,2193898,558
294,5,2195648,0,0,0
295,3,2273050,201,2273670,620
296,3,2275417,201,2276023,606
297,3,2277942,202,2278583,641
298,3,2280284,201,2281111,827
299,3,2282667,201,2283304,637
300,5,2284934,201,2285560,626
301,3,2287492,202,2288088,596
302,5,2289759,201,2290313,554
303,3,2292092,201,2292873,781
304,7,2294392,201,2295033,641
305,7,2296709,202,2297434,725
306,5,2298951,201,2299562,611
307,7,2301476,201,2302106,630
308,7,2303709,201,2304363,654
309,5,2305934,202,2306491,557
310,3,2308209,201,2308907,698
311,7,2310476,202,2311340,864
312,3,2313026,202,2313612,586
313,5,2315626,201,2316237,611
314,7,2318151,202,2318845,694
315,3,2367661,202,2368452,791
316,3,2369961,201,2370533,572
317,3,2372553,201,2373317,764
318,5,2375061,201,2375765,704
319,7,2377453,202,2378054,601
320,3,2379678,201,2380454,776
321,7,2381911,201,2382550,639
322,7,2384403,202,2385191,788
323,7,2386811,201,2387463,652
324,3,2389153,202,2389879,726
325,5,2398887,201,2399641,754
326,3,2401437,202,2402169,732
327,7,2403954,201,2404570,616
328,5,2406370,201,2406954,584
329,7,2408945,201,2409626,681
330,5,2411454,201,2412011,557
331,5,2413821,202,2414411,590
332,3,2416254,201,2416907,653
333,3,2418587,202,2419308,721
334,3,2420912,202,2421852,940
335,7,2423179,201,2423773,594
336,5,2425563,202,2426285,722
337,7,2428088,201,2428685,597
338,7,2430529,201,2431182,653
339,3,2432913,202,2433422,509
340,5,2435304,202,2436078,774
341,5,2437746,201,2438239,493
342,5,2440205,201,2440815,610
343,3,2442763,202,2443391,628
344,5,2445130,201,2445616,486
345,3,2447696,201,2448272,576
346,3,2450147,201,2450672,525
347,7,2452522,201,2453137,615
348,7,2454963,202,2455489,526
349,5,2457322,201,2457809,487
350,5,2459772,201,2460354,582
351,5,2461980,201,2462562,582
352,7,2464397,202,2464962,565
353,7,2466880,201,2467443,563
354,3,2469322,202,2469923,601
355,3,2471864,201,2472484,620
356,7,2474322,202,2474932,610
357,3,2519090,202,2519835,745
358,5,2521507,201,2522059,552
359,7,2523840,201,2524315,475
360,3,2526290,201,2526988,698
361,3,2528590,202,2529036,446
362,5,2531090,201,2531404,314
363,5,2533499,201,2534221,722
364,5,2536032,202,2536717,685
365,5,2538374,202,2539181,807
366,7,2540932,201,2541518,586
367,7,2543174,201,2543742,568
368,5,2545566,202,2546366,800
369,5,2547999,201,2548639,640
370,3,2550474,202,2551231,757
371,7,2552724,201,2553472,748
372,3,2555116,202,2555648,532
373,7,2557383,202,2558016,633
374,5,2559641,202,2560609,968
375,5,2562033,201,2562737,704
376,5,2564333,202,2564961,628
377,5,2566925,201,2567458,533
378,7,2569408,201,2570178,770
379,3,2571942,202,2572578,636
380,7,2574283,201,2575219,936
381,3,2576800,202,2577379,579
382,7,2579158,201,2579891,733
383,3,2581383,202,2582068,685
384,7,2583892,201,2584404,512
385,7,2586359,202,2587301,942
386,5,2588875,201,2589445,570
387,7,2591367,201,2592085,718
388,3,2593692,202,2594326,634
389,3,2596126,201,2596758,632
390,3,2598426,202,2599062,636
391,3,2600992,201,2601543,551
392,5,2603351,202,2603975,624
393,5,2605776,201,2606343,567
394,7,2608076,202,2608680,604
395,3,2610334,201,2610872,538
396,7,2612734,202,2613400,666
397,7,2615176,201,2615737,561
398,3,2617518,202,2618089,571
399,5,2619943,201,2620569,626
400,3,2622460,202,2623130,670
401,7,2624760,201,2625386,626
402,5,2680636,201,2682051,1415
403,7,2690311,201,2690756,445
404,3,2692662,201,2693284,622
405,7,2694887,201,2695396,509
406,3,2697370,202,2697893,523
407,7,2699720,201,2700277,557
408,3,2702028,201,2702534,506
409,7,2704562,201,2705142,580
410,7,2706937,202,2707350,413
411,5,2709170,201,2709639,469
412,3,2711379,202,2711959,580
413,7,2713679,201,2714199,520
414,7,2716262,201,2716824,562
415,3,2718537,202,2719112,575
416,3,2720854,202,2721368,514
417,5,2723237,202,2723769,532
418,7,2725812,201,2726377,565
419,3,2728221,201,2728777,556
420,3,2730779,202,2731370,591
421,5,2733321,201,2733915,594
422,5,2735621,202,2736315,694
423,5,2738021,202,2738635,614
424,3,2740355,202,2741083,728
425,7,2742905,202,2743676,771
426,5,2745321,201,2745964,643
427,3,2747763,201,2748508,745
428,5,2750338,201,2750973,635
429,7,2752913,202,2753309,396
430,7,2755405,201,2755965,560
431,5,2757755,202,2758350,595
432,5,2760230,201,2760814,584
433,3,2762505,201,2763038,533
434,5,2764847,201,2765359,512
435,7,2767414,201,2767999,585
436,7,2770014,201,2770624,610
437,5,2772547,201,2773200,653
438,7,2775089,201,2775888,799
439,3,2777647,202,2778113,466
440,5,2780222,202,2780865,643
441,3,2782572,202,2783105,533
442,3,2784864,202,2785394,530
443,3,2787272,202,2787858,586
444,7,2917818,201,2918389,571
445,3,2920384,202,2920982,598
446,3,2922909,202,2923334,425
447,5,2925285,201,2925846,561
448,5,2927535,201,2927959,424
449,7,2929851,201,2930439,588
450,7,2932335,201,2932904,569
451,5,2934651,202,2935096,445
452,3,2937218,202,2937704,486
453,5,2939818,201,2940345,527
454,3,2942410,202,2942985,575
455,5,2945002,202,2945609,607
456,7,2947260,201,2947850,590
457,3,2949469,201,2950026,557
458,5,2951727,201,2952362,635
459,7,2953960,201,2954507,547
460,7,2956444,201,2957035,591
461,7,2958677,202,2959179,502
462,5,2961002,202,2961676,674
463,3,2963319,202,2963964,645
464,5,2965669,201,2966300,631
465,7,2968202,201,2968781,579
466,5,2970627,201,2971149,522
467,3,2973161,202,2973726,565
468,3,2975386,202,2976062,676
469,5,2977828,201,2978398,570
470,7,2980061,201,2980558,497
471,3,2982603,202,2983263,660
472,7,2985203,201,2985759,556
473,5,2987520,201,2988064,544
474,3,2989953,202,2990432,479
475,7,2992195,201,2992688,493
476,5,2994553,201,2995073,520
477,5,2996953,202,2997473,520
478,7,2999428,201,2999889,461
479,7,3001645,201,3002290,645
480,3,3003995,201,3004626,631
481,3,3006353,202,3006802,449
482,3,3008845,201,3009411,566
483,7,3011079,201,3011747,668
484,5,3013404,201,3013987,583
485,3,3015712,202,3016212,500
486,5,3018095,201,3018532,437
487,7,3020546,201,3021093,547
488,3,3022829,202,3023317,488
